#########################
#                       #
#   S                   #
#                       #
#                       #
#                       #
#             A         #
#                       #
#########################                   
