###########
#         #
# S       #
#         #
#   A     #
#        S#
###########
