%%%%%%%%%%%
%S  A     %
%         %
%         %
%         %
%        S%
%%%%%%%%%%%